1111
1000E1
10C001
1001
100P0001
11111
