111111111111111
100000000000001
10C0000000C0001
100000000000001
10000C000000001
1000000P00000E1
111111111111111
