111111111111
1C00000000E1
111100C00001
10010000C001
1P0100000001
111111111111
