1111111
100C001
1E000P0
1111111
