11111111

10010001

1P000C01

10000E01

11111111




