111111111
1P00000P1
100C00C01
1000E0001
111111111
